┌----------------------------------------------┬--------------┬-----------------------------------------------------------------------------┐
|                                              |              |                                                                             |
|                                              |              |                                                                             |
|                                              |              |                                                                             |
|                                              |              |                                                                             |
|                                              |              |                                                                             |
|                                              |              |                                                                             |
|                                              |              |                                                                             |
|                                              |              |                                                                             |
|                                              |              |                                                                             |
|                                              |              |                                                                             |
|                                              |              |                                                   ┌-------------------------┤
|                                              └--------------┘                                                   |                         |
|             ┌-----          -----┐                                                                                                        |                         |
|             | +++++++++++++++    |                                                                              |                         |
|             | +++++++++++++++    |                                                                              |                         |
|             | +++++++++++++++    |                                                                              |                         |
|             | +++++++++++++++    |                                                                              |                         |
|             | +++++++++++++++    |                                                    ┌--------┐                |                         |
|             | +++++++++++++++    |                                                    |        |                |                         |
|             | +++++++++++++++    |                                                    |        |                |                         |
|             | +++++++++++++++    |                                                    |        |                |                         |
|             | +++++++++++++++    |                                                    |        |                |                         |
|             └--------------------┴-----------------------------┐                      |        |                |                         |
|                                                      @@@@@@@@@ |                      |        |                                          |
|                                                      @@@@@@@@@ |                      |        |                                          |
|                                                      @@@@@@@@@ |                      |        |                                          |
|                                                      @@@@@@@@@ |                      |        |                                          |
|                                                      @@@@@@@@@ |                      |        |                                          |
|                                                      @@@@@@@@@ |                      |        |                                          |
|                                                      @@@@@@@@@ |                      |        |                                          |
└----------------------------------------------------------------┴----------------------┴--------┴------------------------------------------┘