┌----------------------------------------------┬--------------┬-----------------------------------------------------------------------------┐
|                                              |              |                                                                             |
|                                              |              |                                                                             |
|                                              |              |                                                                             |
|                                              |              |                                                                             |
|                                              |              |                                                                             |
|                                              |              |                                                                             |
|                                              |              |                                                                             |
|                                              |              |                                                                             |
|                                                                                                                                           |
|                                                                                                                                           |
|                                                                                                                 ┌-------------------------┤
|                                                                                                                 |                         |
|                  ┌               ┐                                                                              |                         |                         |
|                  |++++++++++     |                                                                              |                         |
|                  |++++++++++     |                                                                              |                         |
|                  |++++++++++     |                                                                              |                         |
|                  |++++++++++     |                                                                              |                         |
|                  |++++++++++     |                                                    ┌--------┐                |                         |
|                  |++++++++++     |                                                    |        |                |                         |
|                  |++++++++++     |                                                    |        |                |                         |
|                  |++++++++++     |                                                    |        |                |                         |
|                  |++++++++++     |                                                    |        |                |                         |
|                  └---------------┴-----------------------------┐                      |        |                |                         |
|                                                      @@@@@@@@@ |                      |        |                                          |
|                                                      @@@@@@@@@ |                      |        |                                          |
|                                                      @@@@@@@@@ |                      |        |                                          |
|                                                      @@@@@@@@@ |                      |        |                                          |
|                                                      @@@@@@@@@ |                      |        |                                          |
|                                                      @@@@@@@@@ |                      |        |                                          |
|                                                      @@@@@@@@@ |                      |        |                                          |
|                                                                |                      |        |                                          | 
|                                                                |                      |        |                                          | 
|                                                                |                      |        |                                          | 
|                                                                |                      |        |                                          | 
└----------------------------------------------------------------┴----------------------┴--------┴------------------------------------------┘